[107, 107, 107, 107, 107, 107, 459, 460, 107, 107, 107, 107, 107, 107, 459, 460, 105, 105, 105, 105, 459, 460, 107, 107, 107, 107, 107, 107, 107, 107, 107, 107, 107, 107, 107, 107, 459, 460, 107, 107,]
[107, 107, 107, 107, 107, 107, 495, 496, 107, 107, 107, 107, 107, 107, 495, 496, 105, 105, 105, 105, 495, 496, 107, 107, 107, 107, 107, 107, 107, 107, 107, 107, 107, 107, 107, 107, 495, 496, 107, 107,]
[459, 460, 459, 460, 459, 460, 459, 460, 459, 460, 459, 460, 459, 460, 459, 460, 105, 105, 105, 105, 459, 460, 459, 460, 459, 460, 459, 460, 459, 460, 459, 460, 459, 460, 459, 460, 459, 460, 459, 460,]
[495, 496, 495, 496, 495, 496, 495, 496, 495, 496, 495, 496, 495, 496, 495, 496, 105, 105, 105, 105, 495, 496, 495, 496, 495, 496, 495, 496, 495, 496, 495, 496, 495, 496, 495, 496, 495, 496, 495, 496,]
[459, 460, 107, 107, 465, 465, 465, 465, 465, 465, 465, 465, 465, 465, 465, 465, 465, 465, 465, 465, 465, 465, 465, 465, 465, 465, 465, 465, 465, 465, 465, 465, 465, 465, 465, 465, 107, 107, 459, 460,]
[495, 496, 107, 107, 465, 465, 465, 465, 465, 465, 465, 465, 465, 465, 465, 465, 465, 465, 465, 465, 465, 465, 465, 465, 465, 465, 465, 465, 465, 465, 465, 465, 465, 465, 465, 465, 107, 107, 495, 496,]
[459, 460, 107, 107, 465, 465, 465, 465, 444, 445, 446, 446, 446, 446, 449, 450, 465, 465, 465, 465, 465, 465, 465, 465, 444, 445, 446, 446, 446, 446, 449, 450, 465, 465, 465, 465, 107, 107, 459, 460,]
[495, 496, 107, 107, 465, 465, 465, 465, 480, 481, 482, 482, 482, 482, 485, 486, 465, 465, 465, 465, 465, 465, 465, 465, 480, 481, 482, 482, 482, 482, 485, 486, 465, 465, 465, 465, 107, 107, 495, 496,]
[459, 460, 107, 107, 465, 465, 465, 465, 416, 417, 418, 419, 418, 418, 521, 522, 465, 465, 465, 465, 465, 465, 465, 465, 416, 417, 418, 419, 418, 418, 521, 522, 465, 465, 465, 465, 107, 107, 459, 460,]
[495, 496, 107, 107, 465, 465, 465, 465, 552, 553, 553, 553, 553, 553, 553, 558, 465, 465, 465, 465, 465, 465, 465, 465, 552, 553, 553, 553, 553, 553, 553, 558, 465, 465, 465, 465, 107, 107, 495, 496,]
[459, 460, 107, 107, 465, 465, 531, 532, 588, 589, 590, 591, 418, 418, 589, 594, 465, 465, 465, 465, 465, 465, 531, 532, 588, 589, 590, 591, 418, 418, 589, 594, 465, 465, 465, 465, 107, 107, 459, 460,]
[495, 496, 107, 107, 465, 465, 567, 568, 624, 625, 626, 627, 625, 625, 625, 630, 465, 465, 465, 465, 465, 465, 567, 568, 624, 625, 626, 627, 625, 625, 625, 630, 465, 465, 465, 465, 107, 107, 495, 496,]
[459, 460, 107, 107, 465, 465, 465, 465, 465, 465, 465, 465, 465, 465, 465, 465, 465, 465, 465, 465, 465, 465, 465, 465, 465, 465, 465, 465, 465, 465, 465, 465, 465, 465, 465, 465, 107, 107, 459, 460,]
[495, 496, 107, 107, 465, 465, 465, 465, 465, 465, 465, 465, 465, 465, 465, 465, 465, 465, 465, 465, 465, 465, 465, 465, 465, 465, 465, 465, 465, 465, 465, 465, 465, 465, 465, 465, 107, 107, 495, 496,]
[459, 460, 107, 107, 465, 465, 465, 465, 465, 465, 465, 465, 465, 465, 465, 465, 465, 465, 465, 465, 465, 465, 465, 465, 465, 465, 465, 465, 465, 465, 465, 465, 465, 465, 465, 465, 107, 107, 459, 460,]
[495, 496, 107, 107, 465, 465, 465, 465, 465, 465, 465, 465, 465, 465, 465, 465, 465, 465, 465, 465, 465, 465, 465, 465, 465, 465, 465, 465, 465, 465, 465, 465, 465, 465, 465, 465, 107, 107, 495, 496,]
[459, 460, 107, 107, 465, 465, 465, 465, 465, 465, 465, 465, 465, 465, 465, 465, 465, 465, 465, 465, 451, 452, 452, 452, 452, 452, 452, 452, 452, 452, 452, 458, 465, 465, 465, 465, 107, 107, 459, 460,]
[495, 496, 107, 107, 465, 465, 465, 465, 465, 465, 465, 465, 465, 465, 465, 465, 465, 465, 465, 465, 487, 488, 488, 488, 488, 488, 488, 488, 488, 488, 488, 494, 465, 465, 465, 465, 107, 107, 495, 496,]
[459, 460, 107, 107, 465, 465, 465, 465, 461, 461, 461, 461, 461, 461, 531, 532, 465, 465, 465, 465, 487, 488, 488, 488, 488, 488, 488, 488, 488, 488, 488, 494, 465, 465, 465, 465, 107, 107, 459, 460,]
[495, 496, 107, 107, 465, 465, 465, 465, 497, 497, 497, 497, 497, 497, 567, 568, 465, 465, 465, 465, 523, 524, 524, 524, 524, 524, 524, 524, 524, 524, 524, 530, 465, 465, 465, 465, 107, 107, 495, 496,]
[459, 460, 107, 107, 465, 465, 465, 465, 107, 107, 107, 107, 107, 107, 107, 107, 465, 465, 465, 465, 559, 560, 560, 560, 560, 596, 596, 560, 560, 560, 560, 566, 465, 465, 465, 465, 107, 107, 459, 460,]
[495, 496, 107, 107, 465, 465, 465, 465, 107, 616, 107, 616, 107, 616, 107, 616, 465, 465, 465, 465, 559, 596, 596, 596, 596, 596, 596, 596, 596, 596, 596, 566, 465, 465, 465, 465, 107, 107, 495, 496,]
[459, 460, 107, 107, 465, 465, 465, 465, 616, 107, 616, 107, 616, 107, 616, 107, 465, 465, 465, 465, 559, 596, 596, 596, 590, 591, 560, 560, 596, 596, 596, 566, 465, 465, 465, 465, 107, 107, 459, 460,]
[495, 496, 107, 107, 465, 465, 465, 465, 107, 107, 107, 107, 107, 107, 107, 107, 465, 465, 465, 465, 631, 632, 632, 632, 626, 627, 632, 632, 632, 632, 632, 638, 465, 465, 465, 465, 107, 107, 495, 496,]
[459, 460, 107, 107, 465, 465, 465, 465, 465, 465, 465, 465, 465, 465, 465, 465, 465, 465, 465, 465, 465, 465, 465, 465, 465, 465, 465, 465, 465, 465, 465, 465, 465, 465, 465, 465, 107, 107, 459, 460,]
[495, 496, 107, 107, 465, 465, 465, 465, 465, 465, 465, 465, 465, 465, 465, 465, 465, 465, 465, 465, 465, 465, 465, 465, 465, 465, 465, 465, 465, 465, 465, 465, 465, 465, 465, 465, 107, 107, 495, 496,]
[459, 460, 107, 107, 465, 465, 465, 465, 465, 465, 465, 465, 465, 465, 465, 465, 465, 465, 465, 465, 461, 461, 461, 461, 461, 461, 531, 532, 461, 461, 461, 461, 465, 465, 465, 465, 107, 107, 459, 460,]
[495, 496, 107, 107, 465, 465, 465, 465, 465, 465, 465, 465, 465, 465, 465, 465, 465, 465, 465, 465, 497, 497, 497, 497, 497, 497, 567, 568, 497, 497, 497, 497, 465, 465, 465, 465, 107, 107, 495, 496,]
[459, 460, 107, 107, 107, 107, 107, 107, 641, 641, 641, 641, 641, 641, 641, 644, 465, 465, 465, 465, 107, 107, 107, 107, 107, 107, 107, 107, 107, 107, 107, 107, 465, 465, 465, 465, 107, 107, 459, 460,]
[495, 496, 107, 107, 107, 107, 107, 107, 641, 642, 642, 642, 642, 642, 642, 644, 465, 465, 465, 465, 107, 616, 107, 616, 107, 616, 107, 616, 107, 107, 107, 107, 465, 465, 465, 465, 107, 107, 495, 496,]
[459, 460, 107, 107, 107, 107, 107, 107, 641, 642, 642, 642, 642, 642, 642, 644, 465, 465, 465, 465, 616, 107, 616, 107, 616, 107, 616, 107, 107, 107, 107, 107, 465, 465, 465, 465, 107, 107, 459, 460,]
[495, 496, 107, 107, 107, 107, 107, 107, 641, 642, 642, 642, 642, 642, 642, 644, 465, 465, 465, 465, 107, 107, 107, 107, 107, 107, 107, 107, 107, 107, 107, 107, 465, 465, 465, 465, 107, 107, 495, 496,]
[459, 460, 107, 107, 107, 107, 107, 107, 641, 642, 642, 642, 642, 642, 642, 644, 465, 465, 465, 465, 465, 465, 465, 465, 465, 465, 465, 465, 465, 465, 465, 465, 465, 465, 465, 465, 107, 107, 459, 460,]
[495, 496, 107, 107, 107, 107, 107, 107, 641, 642, 642, 642, 642, 642, 642, 644, 465, 465, 465, 465, 465, 465, 465, 465, 465, 465, 465, 465, 465, 465, 465, 465, 465, 465, 465, 465, 107, 107, 495, 496,]
[459, 460, 459, 460, 107, 107, 107, 107, 641, 642, 642, 642, 642, 642, 642, 644, 459, 460, 459, 460, 459, 460, 459, 460, 459, 460, 459, 460, 459, 460, 459, 460, 459, 460, 459, 460, 459, 460, 459, 460,]
[495, 496, 495, 496, 107, 107, 107, 107, 641, 642, 642, 642, 642, 642, 642, 644, 495, 496, 495, 496, 495, 496, 495, 496, 495, 496, 495, 496, 495, 496, 495, 496, 495, 496, 495, 496, 495, 496, 495, 496]